20
20
WWWWWWWWWWWWWWWWWWWW
W  W               W
W  W               W
W  D               W
W  W               W
W  WWWWWWWWWW      W
W           W      W
W           W      W
W   WWWWWW  W      W
W   W    W  W      W
W        W  W      W
W     WWWW  WWWW   W
W              W   W
W              W   W
W  E  WWWWWDWWWW   W
W        W  W      W
W        W  W      W
W                  W
W                  W
WWWWWWWWWWWWWWWWWWWW
